56 20
########################################################
#......................................................#
#......................................................#
#......................................................#
#......................................................#
#......................................................#
#..........###......................###....###.........#
#............#..........................$$.............#
#..........######......................####............#
#............#.........................................#
#...................$..................................#
#...................#..................................#
#...................#..............########............#
#..................###.................................#
#..................................#..$$..#............#
#......................................................#
#..................................########............#
#......................................................#
#......................................................#
########################################################